##.#.#.#.#..#.#.
...###.####..###
.#.#.#.#####...#
..#...#.#...#...
..#.#.#.##.#.##.
...###.#.#.....#
##.#.....#.#.##.
..#.##.###.#.#..
#####.##..#...#.
#.#.#.##.#.###..
####..##.#..##..
##......#.##..#.
...#..#.#....##.
....#..#...#...#
.##.###.#..#...#
########.....###
